8
6
1  4  5  5  5  5  6  1
1  7  8  8  8  8  9  1
1 10  8  8  8  8 12  1
1 13 10 11 11 12 15  1
1 16 14 14 14 14 18  1 
1  1 16 17 17 18  1  1